1 1 1 23 23 1 1 1 1 1 1 1 1 1 1 1 1 1 1 1 1 1 1 1 1 1
1 0 0 0 0 0 0 0 0 0 0 0 0 0 0 0 0 0 0 0 0 0 0 0 1 1
1 0 0 0 0 0 0 0 0 0 0 0 0 0 0 0 0 0 0 0 0 0 0 0 1 1
1 0 0 0 0 0 0 2 2 2 2 2 0 0 0 0 0 0 0 0 0 0 0 0 1 1
10 0 0 7 7 0 0 0 0 0 0 1 2 2 0 0 0 2 2 2 2 2 2 2 1 1
10 0 0 0 0 0 0 0 0 0 0 1 0 0 0 5 0 0 0 0 0 0 0 0 1 1
10 9 0 0 0 0 0 0 0 0 0 1 0 0 20 0 0 0 0 0 0 0 0 0 1 1
1 2 2 1 1 2 2 2 0 0 0 1 0 0 0 5 22 0 0 0 0 21 0 0 1 1
1 1 1 1 0 0 0 0 0 0 0 1 0 0 0 0 0 0 0 0 0 0 0 2 1 1
1 1 0 0 0 0 0 0 0 7 7 1 0 0 0 0 0 22 0 0 0 0 2 1 1 1
1 0 0 0 0 0 0 0 0 0 0 1 0 20 0 5 0 0 0 0 0 0 0 0 14 1
1 0 0 0 0 0 0 0 0 0 0 1 0 0 0 0 0 0 0 0 0 0 0 0 14 1
1 0 0 0 0 3 0 0 2 1 1 1 0 0 0 0 0 0 0 0 0 0 0 0 14 1
1 10 10 2 2 2 2 2 1 1 1 2 2 2 2 2 2 2 2 2 2 2 2 2 1 1
1 1 1 1 1 1 1 1 1 1 1 1 1 1 1 1 1 1 1 1 1 1 1 1 1 1