1 1 1 1 1 1 1 1 1 1 1 1 1 1 1 1 1 1 1 1 1 10 10 10 1 1
0 11 0 0 0 0 0 0 0 0 0 0 0 0 0 0 0 0 0 0 1 10 10 10 1 1
0 11 0 0 0 0 0 0 0 0 0 0 20 0 0 0 0 0 0 0 1 10 10 10 1 1
0 12 0 0 21 0 0 0 0 0 0 0 0 0 0 0 0 0 0 0 1 10 10 10 1 1
2 2 0 0 0 0 0 0 0 0 0 0 0 0 21 0 0 0 0 0 1 10 10 10 1 1
1 1 2 0 0 0 0 0 0 0 0 5 0 0 0 0 0 0 0 0 1 10 10 10 1 1
1 1 1 2 2 0 0 6 0 0 0 0 0 0 0 0 0 0 0 0 1 10 10 10 1 1
1 1 1 1 0 0 0 0 0 0 2 2 2 0 0 0 0 0 0 0 1 10 10 10 1 1
1 0 0 0 0 0 0 0 0 0 0 0 0 0 0 2 0 0 0 0 1 10 10 10 1 1
1 0 0 0 0 0 0 0 0 0 0 0 0 0 0 1 2 0 0 0 1 10 10 10 1 1
1 0 0 0 0 0 0 0 0 0 0 5 0 0 0 0 0 0 7 7 1 10 10 10 1 1
1 0 0 0 0 0 0 0 2 0 0 0 0 0 0 0 0 0 0 0 1 10 10 10 1 1
1 0 0 0 0 0 0 2 1 0 0 0 0 0 0 0 12 0 0 0 1 10 10 10 1 1
1 2 2 2 2 2 2 1 1 4 4 4 4 4 2 2 2 2 1 1 1 14 14 14 1 1
1 1 1 1 1 1 1 1 1 1 1 1 1 1 1 1 1 1 1 1 1 1 1 1 1 1
1 1 1 1 1 1 1 1 1 1 1 1 1 1 1 1 1 1 1 1 1 1 1 1 1 1
