1 0 0 1 1 1 1 1 1 1 1 1 1 1 1 1 1 1 1 1 1 1 1 1 1 1
1 0 0 0 0 0 0 0 0 0 0 0 0 0 0 0 0 0 0 0 0 0 0 0 1 1
1 0 0 0 0 0 0 0 0 0 5 0 0 0 0 0 0 0 0 0 0 0 0 0 1 1
1 2 2 2 0 0 6 0 0 2 2 2 2 2 2 2 2 2 2 2 2 2 0 0 1 1
1 0 0 0 0 0 0 0 0 0 0 0 0 0 0 0 0 0 0 0 0 0 0 0 1 1
1 0 0 0 0 0 0 0 0 0 0 0 0 0 0 0 0 0 0 0 0 0 0 7 1 1
1 0 0 0 0 0 0 0 0 0 0 0 5 0 0 0 0 0 0 9 0 0 0 0 1 1
1 0 0 0 2 2 2 2 2 2 2 2 2 2 2 2 2 2 2 10 10 2 2 10 1 1
1 7 0 0 0 0 0 0 0 0 0 0 0 0 0 0 0 0 1 10 2 1 1 1 1 1
1 0 0 0 0 0 0 0 0 0 0 0 0 0 0 0 0 0 0 2 1 0 0 0 1 1
1 0 0 0 0 9 0 0 0 0 0 0 0 9 0 0 0 0 0 0 0 0 0 0 1 1
1 1 2 2 10 10 2 2 2 2 2 2 10 10 2 2 2 0 0 0 0 0 0 0 1 1
1 1 1 1 2 10 1 1 1 1 1 1 2 10 1 1 1 2 2 0 0 0 0 12 1 1
1 1 1 1 1 2 1 1 1 1 1 1 1 2 1 1 1 1 1 2 2 2 2 2 1 1
1 1 1 1 1 1 1 1 1 1 1 1 1 1 1 1 1 1 1 1 1 1 1 1 1 1