1 1 1 1 1 1 1 1 1 1 1 1 1 1 1 1 1 1 1 1 1 1 1 1 1 1
1 0 0 0 0 0 0 0 0 0 0 0 0 0 0 0 0 0 0 0 0 0 0 0 0 1
1 0 0 0 0 0 0 0 0 0 0 0 0 0 0 0 0 0 0 0 0 0 0 0 11 1
1 0 0 0 0 16 0 0 0 0 26 0 0 0 0 0 0 0 0 0 0 0 0 0 12 1
1 0 0 0 0 0 0 0 0 1 1 1 0 0 0 0 0 0 0 0 0 25 0 1 1 1
1 0 0 0 0 0 0 0 0 0 1 0 0 0 0 0 0 26 0 0 1 1 1 1 1 1
1 0 0 0 0 0 0 0 0 0 0 0 0 0 0 0 1 1 1 0 0 0 1 1 1 1
1 0 27 0 0 0 0 0 0 0 0 0 0 0 0 0 0 1 0 0 0 0 0 1 1 1
1 1 1 0 0 0 0 0 0 0 0 0 0 0 0 7 0 0 0 0 0 0 0 0 1 1
1 1 1 0 0 0 0 0 0 0 0 0 25 0 0 0 0 0 0 0 0 0 27 0 1 1
1 1 0 0 0 0 0 0 0 0 0 1 1 1 0 0 0 0 0 0 0 1 1 1 1 1
1 1 0 0 0 0 0 0 1 0 0 0 1 0 0 0 0 0 15 0 0 0 0 1 1 1
1 1 1 0 0 24 0 0 1 0 0 0 0 0 0 0 0 0 0 0 0 0 0 0 1 1
1 1 1 1 1 1 1 1 1 1 4 4 4 4 4 4 4 4 4 4 4 4 4 4 1 1
1 1 1 1 1 1 1 1 1 1 1 1 1 1 1 1 1 1 1 1 1 1 1 1 1 1